3 2
1
3 4
1 1 1 1 1 1 1 1
1 0 0 0 0 0 0 1
1 0 0 0 0 0 0 1
1 0 0 0 0 0 9 1
1 0 0 0 0 0 0 1
1 1 1 1 1 1 1 1
