3 2
2
2 4
2 5
1 1 1 1 1 1 1 1
1 9 0 0 0 0 0 1
1 0 0 0 0 0 9 1
1 0 0 0 0 0 0 1
1 1 1 1 1 1 1 1
0 0 0 0 0 0 0 0
