4 5
3
2 4
2 5
4 3
1 1 1 1 1 1 1 1
1 0 0 0 0 0 0 1
1 0 1 0 0 0 0 1
1 0 1 9 1 9 0 1
1 0 0 0 0 0 9 1
1 1 1 1 1 1 1 1